NO ./textures/north_texture.xpm
SO ./textures/south_texture.xpm
WE ./textures/west_texture.xpm
EA ./textures/east_texture.xpm
C 220,100,0
F 18,50,150

111111
100101
101001
1100N1
111111
